Virtual Reality	VR
Utes	utes
Razoreniya	razoreniya
Sahrani	Sara
Southern Sahrani	SaraLite
United Sahrani	Sara_dbe1
Chernarus	Chernarus
Chernarus (summer version)	Chernarus_Summer
Porto	Porto
Rahmadi	Intro
Podagorsk	FDF_Isle1_a
Caribou Frontier	Caribou
ToraBora	torabora
Takistan Mountains	Mountains_ACR
Takistan	Takistan
Zargabad	Zargabad
Bystrica	Woodland_ACR
Bukovina	Bootcamp_ACR
Desert	Desert_E
Proving Grounds	ProvingGrounds_PMC
Shapur	Shapur_BAF
MBG Vietnam	MBG_nam
Bovington 5m cell	bovington
Celle 2	mbg_celle2
Stratis	Stratis
Helvantis	anim_helvantis_v2
Kunduz, Afghanistan	Kunduz
Altis	Altis
Isla Duala v3.35	IslaDuala3
Island Panthera v3.36	Panthera3
F.S.F Al Rayak	pja310
Vt5, Suomi Finland - v0.2	vt5